R 1280 960

NO ./textures/eagle.xpm
SO ./textures/mossy.xpm
WE ./textures/redbrick.xpm
EA ./textures/greystone.xpm

S ./textures/barrel.xpm
F 77,92,53
C 163,208,230

		1111111111111111111111111
		1000202000000000000000001
 	11111000222000000000020000011
	11111001020000000000000002001
111111111011000001110000000000001
100000000011000001110111110111111
111101111111110111000000100011
11110111111111011101010010001111111
110000000001010111000000100011
1000201110000000110000001000111111111
1000001 1000000011010100100011
110000111010101111100011000111
1111N00000110101111000000100011
111111111111111111111111111111
